beloof	verb
televisie	noun
haag	noun
tafel	noun
lees	verb
gezicht	noun
geef	verb
rietje	noun
sta	verb
werp	verb
glas	noun
koning	noun
promoveer	verb
meisje	noun
misdraag	verb
vork	noun
dakraam	noun
penningmeester	noun
dien	verb
neem	verb
ga	verb
perkament	noun
vang	verb
schiet	verb
mes	noun
noem	verb
rehabiliteer	verb
lucifer	noun
bes	noun
kampeer	verb
